10 13
WWWWWWWWGW
W00000000W
W0W0WWWWWW
W0WE0000eW
WWWWWWWW0W
WWdC000D0W
WcWW0WWWWW
W000B00WWW
WWWWWW00bW
WaWWWA0WWW
W00000WWWW
WSWWWWWWWW
WWWWWWWWWW