10 8
WWWWWWWWWW
WWW0000WGW
WdWCWW000W
W0W0WbWWWW
W00B00000W
WWWWWWWW0W
WS00a00A0W
WWWWWWWWWW
